############# ###############
#             ###   ##      #
####  # ##### ###   #####   #
#  #  # #     ###           #
#  #  ###  #####  ####      #
#  #       # #       #  ##  #
#  ####    ###   #####  ##  #
#                    #      #
####   ##### #  ######  #####
#  #   #  #  #              #
#         #  #   ##   #######
#  ####   #  ######   ###   #
#     #   #      ##   ###   #
#######   ###################